GST Road ----> Gst Road
GST Crossing ----> Gst Crossing
Ring Road ----> Ring Road
B/H AryaVilla ----> B/H Aryavilla
Samartheshwar Mahadev Road ----> Samartheshwar Mahadev Road
Sindhu bhawan road ----> Sindhu Bhawan Road
Dada Bhagwan Trimandir, Ahmedabad - Kalol Highway, Adalaj, Gandhinagar, Gujarat, India  ----> Dada Bhagwan Trimandir Ahmedabad - Kalol Highway Adalaj Gandhinagar 
FACTORY Road no.14 ----> Factory Road No.14
Commerce College Road ----> Commerce College Road
Gujarat University Internal Road ----> Gujarat University Internal Road
Drive-in Road ----> Drive-In Road
100 Ft. Road ----> 100 Ft. Road
Law Garden Road ----> Law Garden Road
Khokhra Road ----> Khokhra Road
bunglow area ----> Bunglow Area
Ashram Road ----> Ashram Road
Navrang Society ----> Navrang Society
Nirant Building, Simandhar City ----> Nirant Building, Simandhar City
St. Xavier's College Road ----> St. Xavier'S College Road
SH-41 ----> Sh-41
Vatva railway station road ----> Vatva Railway Station Road
Rakhial Road ----> Rakhial Road
Shree Bapalal Dandwala Marg ----> Shree Bapalal Dandwala Marg
Nehrunagar ----> Nehrunagar
Swami Vivekananda Road ----> Swami Vivekananda Road
CG Road ----> Cg Road
Rambaug, Near Karnavati Club Road ----> Rambaug, Near Karnavati Club Road
Pragatinagar ----> Pragatinagar
tajpur road ----> Tajpur Road
SPEC House, Parth Complex, Navrangpura, Nr. Swastik Cross Roads ----> Spec House, Parth Complex, Navrangpura, Nr. Swastik Cross Roads
Uttamnagar, Maninagar ----> Uttamnagar, Maninagar
Kotar pur-airport road ----> Kotar Pur-Airport Road
GST Crossing Road, Ranip ----> Gst Crossing Road, Ranip
Gurukul Road, Vishram Marg ----> Gurukul Road, Vishram Marg
Satya Marg ----> Satya Marg
vijay char rasta ----> Vijay Char Rasta
sargasan, kh road ----> Sargasan, Kh Road
mauraya gidc maha gujrat gidc road ----> Mauraya Gidc Maha Gujrat Gidc Road
Prasang Party Plot Rd, Chanakyapuri ----> Prasang Party Plot Rd, Chanakyapuri
Nehru Bridge ----> Nehru Bridge
shreyas flyover service road ----> Shreyas Flyover Service Road
Nirnaynagar road ----> Nirnaynagar Road
Jawaharlal Nehru Road ----> Jawaharlal Nehru Road
paldi gam road ----> Paldi Gam Road
LD College of Engineering Internal Road ----> Ld College Of Engineering Internal Road
ASarwa ----> Asarwa
BRTS Station ----> Brts Station
Lal Darwaja ----> Lal Darwaja
8 aasiyana society jivrajpark nr 132 ring road ahmedabad ----> 8 Aasiyana Society Jivrajpark Nr 132 Ring Road 
Gota Road ----> Gota Road
Kendriy Vihar Society ----> Kendriy Vihar Society
Sargasan Cross Road ----> Sargasan Cross Road
Narol Sarkhej Road ----> Narol Sarkhej Road
Gandhi Road ----> Gandhi Road
Kh-0 ----> Kh-0
Jamalpur Road ----> Jamalpur Road
Near Vyasvadi ----> Near Vyasvadi
Adalaj -sarkhej road ----> Adalaj -Sarkhej Road
Vatwa Road ----> Vatwa Road
Akshar Avenue ----> Akshar Avenue
Akhabarnagar Circle ----> Akhabarnagar Circle
Station Road ----> Station Road
Shyam Sunder Row House, Behind Manav Mandir ----> Shyam Sunder Row House, Behind Manav Mandir
Hebatpur road ----> Hebatpur Road
Heena Park Sosciety, Settellte ----> Heena Park Sosciety, Settellte
Shantigram ----> Shantigram
Balol Nagar Road ----> Balol Nagar Road
Bapunagar ----> Bapunagar
Dutt Socity, Bhattha, Paldi ----> Dutt Socity, Bhattha, Paldi
Hirawadi ----> Hirawadi
kh road ----> Kh Road
Kendriya Vihar Society ----> Kendriya Vihar Society
Tirupati Road ----> Tirupati Road
Chimanlal Girdharlal Road ----> Chimanlal Girdharlal Road
Bapuangar ----> Bapuangar
Manek Baug Road ----> Manek Baug Road
Swami Bapa Smruti Mandir Road ----> Swami Bapa Smruti Mandir Road
एरपोर्ट रोड ----> Airport Road
Sabarmati Riverfront Walkway, Usmanpura ----> Sabarmati Riverfront Walkway, Usmanpura
Near Krishnabaug Cross Roads, Maninagar ----> Near Krishnabaug Cross Roads, Maninagar
Khanpur ----> Khanpur
Ellisbridge ----> Ellisbridge
NEW ROAD NIRNAYNAGAR ----> New Road Nirnaynagar
Odhav Road ----> Odhav Road
Panchvati Crossroads ----> Panchvati Crossroads
Vijubhai Dave Marg ----> Vijubhai Dave Marg
Shri Nirankar Society - Bhairavnath Road ----> Shri Nirankar Society - Bhairavnath Road
Serenade Farm, Survey no. 121, Sughad, Near Koba circle ----> Serenade Farm, Survey No. 121, Sughad, Near Koba Circle
ramdev nagar road ----> Ramdev Nagar Road
Nr. Chandan Party Plot ----> Nr. Chandan Party Plot
Indira Bridge Circle . Apollo Complex ----> Indira Bridge Circle . Apollo Complex
Paldi ----> Paldi
Hirawadi road ----> Hirawadi Road
Anand nagar road ----> Anand Nagar Road
100 ft Road ----> 100 Ft Road
Ramji temple, Bhattha Paldi ----> Ramji Temple, Bhattha Paldi
Behind Ayodhyanagar ----> Behind Ayodhyanagar
101, Paritosh Building, Usmanpura, Ashram Road ----> 101, Paritosh Building, Usmanpura, Ashram Road
Rabari colony road ----> Rabari Colony Road
Ahmedabad-Kalol Highway ----> Ahmedabad-Kalol Highway
Balvantrai Mehta Road ----> Balvantrai Mehta Road
Bhadaj Cross Road, ----> Bhadaj Cross Road,
Gidc 1 road ----> Gidc 1 Road
Corporate Road ----> Corporate Road
vijay cross road ----> Vijay Cross Road
Sundarvan, Satellite Road ----> Sundarvan, Satellite Road
Lala Lajpat Rai Marg ----> Lala Lajpat Rai Marg
New Nirnaynaga Road ----> New Nirnaynaga Road
Gujarat ----> Gujarat
Netaji Subhash Chandra Road ----> Netaji Subhash Chandra Road
Purshottam Malvankar Marg ----> Purshottam Malvankar Marg
Naroda Road ----> Naroda Road
Stadium Circle ----> Stadium Circle
Indroda Circle ----> Indroda Circle
JUNA MADHUPURA ROAD ----> Juna Madhupura Road
Sola Road ----> Sola Road
CHANDLODIA STATION ROAD ----> Chandlodia Station Road
Dutt society, Bhattha ----> Dutt Society, Bhattha
Swastik Cross Road ----> Swastik Cross Road
sbk society ----> Sbk Society
Dr. Vikram Sarabhai Road ----> Dr. Vikram Sarabhai Road
Bhagwat Nagar Society ----> Bhagwat Nagar Society
N. Palm Ave. #210 ----> N. Palm Ave. #210
Asmita Society ----> Asmita Society
Girdharnagar Road ----> Girdharnagar Road
Krupa Shankar Joshi Marg ----> Krupa Shankar Joshi Marg
Opposite Sidi Saiyad Jali ----> Opposite Sidi Saiyad Jali
Thaltej Road ----> Thaltej Road
Judges Bunglow Road ----> Judges Bunglow Road
Stadium Commerce Six Roads ----> Stadium Commerce Six Roads
S.G. Highway ----> S.G. Highway
Sector 1 ----> Sector 1
132 Ft. Ring Road ----> 132 Ft. Ring Road
D12, Asmaakam, Makrba road, Vejalpur ----> D12, Asmaakam, Makrba Road, Vejalpur
Near Balolnagar Cross Road ----> Near Balolnagar Cross Road
Astodia ----> Astodia
Judges Bungalow Road ----> Judges Bungalow Road
Uttamnagar, Ahmedabad ----> Uttamnagar 
kathwada GiDc road ----> Kathwada Gidc Road
SM Road ----> Sm Road
Sargam Marg ----> Sargam Marg
Dr. Hariprasad Desai Marg ----> Dr. Hariprasad Desai Marg
C.G. Road ----> C.G. Road
sidhubahavan road ----> Sidhubahavan Road
Sargasan cross road ----> Sargasan Cross Road
GST Crossing Road, New Ranip ----> Gst Crossing Road, New Ranip
Ghatlodia ----> Ghatlodia
Sardar Patel Ring Road ----> Sardar Patel Ring Road
University Road ----> University Road
CH Road ----> Ch Road
Sindhubhavan Road ----> Sindhubhavan Road
Nikol-Naroda Road ----> Nikol-Naroda Road
Kasturba Gandhi Road ----> Kasturba Gandhi Road
Airport Road ----> Airport Road
Shri Khandubhai Desai Marg ----> Shri Khandubhai Desai Marg
S G Highway ----> S G Highway
tanman chokdi ----> Tanman Chokdi
NH8C ----> Nh8C
Hebatpur Road ----> Hebatpur Road
Dr. Ambedkar Road ----> Dr. Ambedkar Road
Vijay Cross Roads ----> Vijay Cross Roads
Thaltej Underbridge ----> Thaltej Underbridge
Dmart road / nikol naroda road ----> Dmart Road / Nikol Naroda Road
GVMM ----> Gvmm
Central Jail road ----> Central Jail Road
Gota Road NH-147 ----> Gota Road Nh-147
shiv-sankalp soc. amikunj cross road ----> Shiv-Sankalp Soc. Amikunj Cross Road
Nav-sarjan School Road ----> Nav-Sarjan School Road
Satellite Road ----> Satellite Road
Service road - Sarkhej Gandhinagar Highway ----> Service Road - Sarkhej Gandhinagar Highway
Ramdevnagar road ----> Ramdevnagar Road
Relief Road ----> Relief Road
S P Ring Road ----> S P Ring Road
Shantivan Cross road ----> Shantivan Cross Road
120 Feet Ring Road ----> 120 Feet Ring Road
Near NH 147 ----> Near Nh 147
SHIVAM  SQUAR ----> Shivam  Squar
ashram road ----> Ashram Road
Gulbai Tekra Road ----> Gulbai Tekra Road
Maninagar ----> Maninagar
NH8 ----> Nh8
Sukharam Nagar Road ----> Sukharam Nagar Road
Gala Gym Khana Road ----> Gala Gym Khana Road
Nikol-Nava Naroda road ----> Nikol-Nava Naroda Road
Nava Naroda Road ----> Nava Naroda Road
North Bopal ----> North Bopal
NH8A ----> Nh8A
Lakhudi Circle ----> Lakhudi Circle
Surendra Mangaldas Road ----> Surendra Mangaldas Road
Mandir orad ----> Mandir Orad
Swastik Society Road ----> Swastik Society Road
Bopal - Sanand Bypass Road ----> Bopal - Sanand Bypass Road
Dr. Jivraj Mehta Road ----> Dr. Jivraj Mehta Road
Sindhu Bhawan Road ----> Sindhu Bhawan Road
GST Crossing, New Ranip ----> Gst Crossing, New Ranip
Vatva GIDC road ----> Vatva Gidc Road
shahpur ----> Shahpur
kankariya gate no.3 ----> Kankariya Gate No.3
Sindhu Bhavan Road ----> Sindhu Bhavan Road
Narmada Residency road ----> Narmada Residency Road
Nav-Sarjan School Road ----> Nav-Sarjan School Road
RTO Circle ----> Rto Circle
BRTS Route ----> Brts Route
ACHER ROAD ----> Acher Road
Vrajraiji Colony ----> Vrajraiji Colony
Satyamev Vista Road ----> Satyamev Vista Road
Danapith Road ----> Danapith Road
2nd Floor, Dev Arc Mall, Satellite Rd, Off S.G Highway, Near Iskcon Bridge ----> 2Nd Floor, Dev Arc Mall, Satellite Rd, Off S.G Highway, Near Iskcon Bridge
BalolNagar Cross Road ----> Balolnagar Cross Road
Vatva phase -2 road ----> Vatva Phase -2 Road
Panjarapole Cross Roads ----> Panjarapole Cross Roads
Ranip ----> Ranip
Kh road ----> Kh Road
2nd Floor, Aditya Complex, Opp kasturi Dining Hall, Paldi Cross Road, Paldi ----> 2Nd Floor, Aditya Complex, Opp Kasturi Dining Hall, Paldi Cross Road, Paldi
Main bazar road road ----> Main Bazar Road Road
gandhi  bridge ----> Gandhi  Bridge
Gandhinagar-Ahmedabad Highway ----> Gandhinagar-Ahmedabad Highway
Vatva-1 Road ----> Vatva-1 Road
